                                                                                                #########       
                                                                                                #® ®© ® #       
                                                                                                # # # # #       
                                                                                                # ®     #       
                                                                                                #®# # # #       
                                                                                                #®   ®® #       
                                                                                                #®# # # #       
                                                                                                #®    ®®#       
                                                                ################################# #®#®# #       
                                                                #  ©     ©® © ® ® © ®®   ©   ®   ®   ® ©#       
                                                                # # # # # # # #©# #®# #®#®# # #®# #©# # #       
                                                                #   ® ©© © ® ©  ®  ®    ®          © ® ©#       
                                                                # #©# #®# # # # # #©# # #®#©#®#®# # #®# #       
                                                                #  ®  ® ®©®  ®  ®  © ®       ©   ®®©   ®#       
                                                                # #®# #©# #®#©#®#®#©# # # #®# #®# #®# # #       
                                                                # ®   ®® ® ®   © ®©®©®     ®® ® ©®®    ®#       
                                                                #©# # # # #®# # #©# #©# #################       
                                                                #® ®© ©  ®®®  ®®©  © ® ®#                       
                                                                # # # # # # # # # # # # #                       
                                                                #®  © © ®    ®®  ©®     #                       
                                                                # #®#®# # #©#®# # # # # #                       
                                                                #®  ®      ®   ©  ®  ©  #                       
                                                                # # #©#©# # #©# # # #©#©#                       
                                                                #   © ® ®     ®    ©®®® #                       
                                                                #©#©# # #©# # # #########                       
                                                                #©©®   ® ©®  ®® #                               
                                                                #®# # # # #®# # #                               
                                                                # ®® ® ®®©©®   ®#                               
                                                                # # #®# # #®#®#®#                               
                                                                # ®©            #                               
                                                                #©# # #®# # #®#®#                               
                                                                #    ©   ®   ®  #                               
                                ################################# #©#®# # # #®# #########                       
                                #     ®    ®® ® ®   ®  ®  ®®  ® ©    ®®®  ®  ® ®®®®   ® #                       
                                # # # # #®#®#©# # #©#®# #®#©# # # # # #©# # # # # #®# # #                       
                                # ®®     ®   ®    ©  ®   ®    ©®  ®® ®© ®® ©®    ®®®®  ®#                       
                                #©# # #®#®# # #©# # # # # # #®# #©# # #©# # # # # # # # #                       
                                # © ®    ® ® ©    ®          ®      ®     ©®©© ®     ©®®#                       
                                #®# # #®#©# # #®# # #®# # # # # # # # # # # # #®#®# # # #                       
                                #®   ®  ®  ®                 ©®  ® ®         ®    ®     #                       
                                # # # # # # # # # # # #©# #®# # #®#©# # #®#®#®#©#®# #©#®#                       
                                #  ® ®    ©         ® ®® ®©       ® ®©    ®    ®®®    ® #                       
                                #©# # # # #©# # # # # # # #®# # # # # #®# # #®# #®#®# # #                       
                                #©©® ©     ®  © ©®®®   ®   ©®   ® ® ®®  ®     ©®© ®     #                       
                                #©#®#©# #©# # # # # #®# #®# # # # #®# # # # # # # # # # #                       
                                #   ®   ®©       ®®®©  © ©     ©© ®      ®®®® ®  ® ®    #                       
                                #®#®# # # #®# # #®#®# # # # #®# #®# #®# #®#®# #®# #®#®# #                       
                                # ©  ® ® ®   ©®  ©   ®®®© ®   ©®®  ®  ®  ®®®   © © ®  ®®#                       
                        #########©#®# # #®# #®# #########################®# #©#©#########                       
                        #        ®®®© ©  ®      #                       #   ®   #                               
                        # #®#®# #®# # # # # # # #                       #©#®# # #                               
                        # ®       ©  © ®    ®© ®#                       #       #                               
                        #©#®# #®#®# #®#®# # # # #                       #©#®# # #                               
                        #® ®      © ®    ®®     #                       # ®    ®#                               
                        #®# # # #®# # # #®# #®#®#                       #®# # # #                               
                        #®®®  ®®      ®®®®  ®  ®#                       #®   ®®©#                               
                        #########################                       #########                               
                                                                                                                
                                                                                                                
                                                                                                                
                                                                                                                
                                                                                                                
                                                                                                                
                                                                                                                
                                                                                                                
                                                                                                                
                                                                                                                
                                                                                                                
                                                                                                                
                                                                                                                
                                                                                                                
                                                                                                                
                                                                                                                
                                                                                                                
                                                                                                                
                                                                                                                
                                                                                                                
                                                                                                                
                                                                                                                
                                                                                                                
                                                                                                                
                                                                                                                
                                                                                                                
                                                                                                                
                                                                                                                
                                                                                                                
                                                                                                                
                                                                                                                
                                                                                                                
                                                                                                                
                                                                                                                
                                                                                                                
                                                                                                                
                                                                                                                
                                                                                                                
                                                                                                                
