                                        #########                                                               
                                        #       #                                                               
                                        # # # # #                                                               
                                        #       #                                                               
                                        # # # # #                                                               
                                        #       #                                                               
                                        # # # # #                                                               
                                        #       #                                                               
                        ################# # # # #########       #########################                       
                        #                               #       #                       #                       
                        # # # # # # # # # # # # # # # # #       # # # # # # # # # # # # #                       
                        #                               #       #                       #                       
                        # # # # # # # # # # # # # # # # #       # # # # # # # # # # # # #                       
                        #                               #       #                       #                       
                        # # # # # # # # # # # # # # # # #       # # # # # # # # # # # # #                       
                        #                               #       #                       #                       
                        # # # # ######### # # # # # # # #       ######### # # # #########                       
                        #       #       #               #               #       #                               
                        # # # # #       # # # # # # # # #               # # # # #                               
                        #       #       #               #               #       #                               
                        # # # # #       # # # # # # # # #               # # # # #                               
                        #       #       #               #               #       #                               
                        # # # # #       # # # # # # # # #               # # # # #                               
                        #       #       #               #               #       #                               
                        ################# # # # #########               # # # # #                               
                                #               #                       #       #                               
                                # # # # # # # # #                       # # # # #                               
                                #               #                       #       #                               
                                # # # # # # # # #                       # # # # #                               
                                #               #                       #       #                               
                                # # # # # # # # #                       # # # # #                               
                                #               #                       #       #                               
                                ######### # # # ######################### # # # #########                       
                                        #                                               #                       
                                        # # # # # # # # # # # # # # # # # # # # # # # # #                       
                                        #                                               #                       
                                        # # # # # # # # # # # # # # # # # # # # # # # # #                       
                                        #                                               #                       
                                        # # # # # # # # # # # # # # # # # # # # # # # # #                       
                                        #                                               #                       
                                        # # # # # # # # # # # # # # # # # # # # #########                       
                                        #                                       #                               
                                        # # # # # # # # # # # # # # # # # # # # #                               
                                        #                                       #                               
                                        # # # # # # # # # # # # # # # # # # # # #                               
                                        #                                       #                               
                                        # # # # # # # # # # # # # # # # # # # # #                               
                                        #                                       #                               
                                        ################################# # # # #########                       
                                                                        #               #                       
                                                                        # # # # # # # # #                       
                                                                        #               #                       
                                                                        # # # # # # # # #                       
                                                                        #               #                       
                                                                        # # # # # # # # #                       
                                                                        #               #                       
                                                                        # # # # #########                       
                                                                        #       #                               
                                                                        # # # # #                               
                                                                        #       #                               
                                                                        # # # # #                               
                                                                        #       #                               
                                                                        # # # # #                               
                                                                        #       #                               
                                                                        #########                               
                                                                                                                
                                                                                                                
                                                                                                                
                                                                                                                
                                                                                                                
                                                                                                                
                                                                                                                
                                                                                                                
                                                                                                                
                                                                                                                
                                                                                                                
                                                                                                                
                                                                                                                
                                                                                                                
                                                                                                                
                                                                                                                
                                                                                                                
                                                                                                                
                                                                                                                
                                                                                                                
                                                                                                                
                                                                                                                
                                                                                                                
                                                                                                                
                                                                                                                
                                                                                                                
                                                                                                                
                                                                                                                
                                                                                                                
                                                                                                                
                                                                                                                
